@@@@@####T
@@@@@####M
@@@@@#####
@@@@@####W
**********
**********
**********
##########
##########
@@@@@@@@@@